
NO ./textures/wall.xpm
F 128,128,128
WE ./textures/wall3.xpm
SO ./textures/wall4.xpm




C 0,0,0

EA ./textures/wall2.xpm

111111111111111111111111111111111111111111
100000000101000000000000000000000000000001
1000E0000000000000000000000000000000000001
100000000001000000000000000000000000000001
110000000011100000000000000000000000000001
110000000011100000000000000000000000000001
111110011111000000000000000000000000000001
100000000000000000000000000000000000000001
100000000000000000000000000000000000000001
100000000000000000000000000000000000000001
100000000000000000000000000000000000000001
100000000000000000000000000000000000010001
111111111111111111111111111111111111111111
