
C 255,   200   ,    160

F  122 , 122 , 122

NO ./pics/redbrick.xpm

SO ./pics/greystone.xpm

WE ./pics/wood.xpm

EA ./pics/bluestone.xpm



1111111
10000011111111   111111
100000111N1111    111011
10000011111111    111111
1111111



