
C 255,   200   ,    160

F  122 , 122 , 122

NO ./pics/redbrick.xpm

SO ./pics/greystone.xpm

WE ./pics/wood.xpm

EA ./pics/bluestone.xpm



11111111
10000001
10100001
10000001
1000W001
10000101
10000101
11111111



