
C 255,   200   ,    160

F  122 , 122 , 122

NO ./textures/wall.xpm

SO ./textures/wall2.xpm

WE ./textures/wall3.xpm

EA ./textures/wall4.xpm



11111111
10000001
10100011
10100011
1010N011
10100101
10000101
11111111


