
C 255,200,160
F 122,122,122
NO ./pics/redbrick.xpm
SO ./pics/greystone.xpm
WE ./pics/wood.xpm
EA ./pics/bluestone.xpm

1111111
10000011111111
100S0011111111
10000011111111
1111111