
C 255,200,160
F 122,122,122
NO ./pics/redbrick.xpm
SO ./pics/greystone.xpm
WE ./pics/wood.xpm
EA ./pics/bluestone.xpm

1111111
1000001
100S001
1000001
1111111